██████████████████████████████████████████████████████████████████████████████████████████████████████████████
█                                                                                                            █
█                                                                                                            █
█                                                                                                            █
█                                                                                                            █
█                                                                                                            █
█                                                                                                            █
█                                                                                                            █
█                                                                                                            █
█                            ██████     █████    ██████    ████████                                          █
█                            ██   ██  ██   ██  ██      ██  ██    ██                                          █
█                            ██     ██     ██  ██████████  ████████                                          █
█                            ██            ██  ██      ██  ██                                                █
█                            ██            ██  ██      ██  ██                                                █
█                                                                                                            █
█                                                                                                            █
█                                                                                                            █
█                                                                                                            █
█                                                                                                            █
█                  ████████████  █████████    ██████   ████████████                                          █
█                       ██       ██         ██              ██                                               █
█                       ██       █████        █████         ██                                               █
█                       ██       ██                ██       ██                                               █
█                       ██       █████████   ██████         ██                                               █
█                                                                                                            █
█                                                                                                            █
█                                                                                                            █
█                                                                                                            █
█                                                                                                            █
█                                                                                                            █
█                                                                                                            █
█                                                                                                            █
█                                                                                                            █
█                                                                                                            █
█                                                                                                            █
█                                                                                                            █
█                                                                                                            █
█                                                                                                            █
█                                                                                                            █
██████████████████████████████████████████████████████████████████████████████████████████████████████████████
